..........................OO..........................
..........................OO..........................
......O....O..............................O....O......
....OO.OOOO.OO..........................OO.OOOO.OO....
......O....O..............................O....O......
......................................................
......................................................
......................................................
......................................................
.........................O..O.........................
.......................O.O..O.O.......................
........................OO..OO........................
..O..O....O..O..........................O..O....O..O..
OOO..OOOOOO..OOO......................OOO..OOOOOO..OOO
..O..O....O..O............OO............O..O....O..O..
..........................OO..........................
......................................................
......................................................
......................................................
.....................O..........O.....................
.....................O..........O.....................
....................O.O........O.O....................
.....................O..........O.....................
.....................O..........O.....................
.....................O..........O.....................
.....................O..........O.....................
....................O.O........O.O....................
.....................O..........O.....................
.....................O..........O.....................