......OO......
......O.O.OO.O
........O.O.OO
........OO....
..............
..............
.OOOOO.....OO.
O....O.....OO.
.....O........
O...O.........
..O...........