O...........
OOOO........
..OO........
.....O......
OOOOOO......
......O.O...
O.O.OOOOOO..
O.OO.....OO.
....OO....OO
OOOOO....OO.
............
OOOOO....OO.
....OO....OO
O.OO.....OO.
O.O.OOOOOO..
......O.O...
OOOOOO......
.....O......
..OO........
OOOO........
O...........