0....0.0....0
00...000...00
.00..000..00.
...00...00...
....00.00....
....00000....
.............
......0......