.......000....
000...0..0....
.....0...0....
.....0..0.....
.....000...000
..........0..0
.........0...0
.........0..0.
.........000..