...000000...
...000000...
..00000000..
..00000000..
.0000..0000.
.000....000.
0000....0000
.000....000.
..00....00..
...00..00...
....0000....