......0.....
....00000...
..00000.00..
.00000...00.
.0000.....0.
0000.....000
.0000...000.
.00000.0000.
..00000000..
...0000000..
....00000...