OO................................................OO
.O................................................O.
.O.O.....................OO.....................O.O.
..OO........O............OO............OO.......OO..
...........OO..........................O.O..........
..........OO.............................O..........
...........OO..OO......................OOO..........
....................................................
....................................................
....................................................
...........OO..OO......................OOO..........
..........OO.............................O..........
...........OO..........................O.O..........
..OO........O............OO............OO.......OO..
.O.O.....................OO.....................O.O.
.O................................................O.
OO................................................O0