...O..O.O..O...
...O..O.O..O...
..OO..O.O..OO..
OOO....O....OOO
.......O.......
...............
OOO.........OOO
...OO.....OO...
OOO.........OOO
...............
.......O.......
OOO....O....OOO
..OO..O.O..OO..
...O..O.O..O...
...O..O.O..O...