.........................OO.......
........................O..O......
.......................O..O.......
.......................O......O...
......................O..O...O.O..
.......................OOO...OO...
..................................
.......................OOO...OO...
......................O..O...O.O..
.......................O......O...
.......................O..O.......
........................O..O......
.........................OO.......
OO................................
OO................................
......O...........................
....OO............................
.....OO...........................
......O...........................
.........OO.......................
.........O........................
.........O..O.....................
..........OO....OO................
...............O..O...............
..................O...............
.................OO...............
.....................O............
.....................OO..........O
......................OO.......O.O
.....................O..........OO
OO........................OO......
OO........................OO......