.OOO.......O
.OO..O.OO.OO
...OOO....O.
.O..O.O...O.
O....O....O.
O....O....O.
.O..O.O...O.
...OOO....O.
.OO..O.OO.OO
.OOO.......O
